26|31
D|D|D|D|D|D|D|D|D|D|D|D|D|D|D|D|D|D|D|D|D|D|D|D|D|D|D|D|D|D|D|
D|C|C|C|C|C|C|C|C|C|C|C|C|C|C|C|C|C|C|C|C|C|C|C|C|C|C|C|C|C|D|
D|C|C|C|C|C|C|C|C|C|C|C|C|C|C|C|C|C|C|C|C|C|C|C|C|C|C|C|C|C|D|
D|C|C|C|C|C|C|C|C|C|C|C|C|C|C|C|C|C|C|C|C|C|C|C|C|C|C|C|C|C|D|
D|C|C|C|C|C|C|C|C|C|C|C|C|C|C|C|C|C|C|C|C|C|C|C|C|C|C|C|C|C|D|
D|C|C|C|C|C|C|C|C|C|C|C|C|C|C|C|C|C|C|C|C|C|C|C|C|C|C|C|C|C|D|
D|C|C|C|C|C|C|C|C|C|C|C|C|C|C|C|C|C|C|C|C|C|C|C|C|C|C|C|C|C|D|
D|C|C|C|C|C|C|C|C|C|C|C|C|C|C|E|E|E|E|C|C|C|C|C|C|C|C|C|C|C|D|
D|C|C|C|C|C|C|C|C|C|C|C|C|C|E|C|C|C|C|E|C|C|C|C|C|C|C|C|C|C|D|
D|C|C|C|C|C|C|C|C|C|C|C|C|E|C|C|C|C|C|E|C|C|C|C|C|C|C|C|C|C|D|
D|C|C|C|C|C|C|C|C|C|C|C|C|C|C|C|C|C|C|E|C|C|C|C|C|C|C|C|C|C|D|
D|C|C|C|C|C|C|C|C|C|C|C|C|C|C|C|C|C|E|E|C|C|C|C|C|C|C|C|C|C|D|
D|C|C|C|C|C|C|C|C|C|C|C|C|C|C|C|C|E|C|C|C|C|C|C|C|C|C|C|C|C|D|
D|C|C|C|C|C|C|C|C|C|C|C|C|C|C|C|E|C|C|C|C|C|C|C|C|C|C|C|C|C|D|
D|C|C|C|C|C|C|C|C|C|C|C|C|C|C|E|C|C|C|C|C|C|C|C|C|C|C|C|C|C|D|
D|C|C|C|C|C|C|C|C|C|C|C|C|C|E|C|C|C|C|C|C|C|C|C|C|C|C|C|C|C|D|
D|C|C|C|C|C|C|C|C|C|C|C|C|E|C|C|C|C|C|E|C|C|C|C|C|C|C|C|C|C|D|
D|C|C|C|C|C|C|C|C|C|C|C|C|E|C|C|C|C|C|E|C|C|C|C|C|C|C|C|C|C|D|
D|C|C|C|C|C|C|C|C|C|C|C|C|E|E|E|E|E|E|E|C|C|C|C|C|C|C|C|C|C|D|
D|C|C|C|C|C|C|C|C|C|C|C|C|C|C|C|C|C|C|C|C|C|C|C|C|C|C|C|C|C|D|
D|C|C|C|C|C|C|C|C|C|C|C|C|C|C|C|C|C|C|C|C|C|C|C|C|C|C|C|C|C|D|
D|C|C|C|C|C|C|C|C|C|C|C|C|C|C|C|C|C|C|C|C|C|C|C|C|C|C|C|C|C|D|
D|C|C|C|C|C|C|C|C|C|C|C|C|C|C|C|C|C|C|C|C|C|C|C|C|C|C|C|C|C|D|
D|C|C|C|C|C|C|C|C|C|C|C|C|C|C|C|C|C|C|C|C|C|C|C|C|C|C|C|C|C|D|
D|C|C|C|C|C|C|C|C|C|C|C|C|C|C|C|C|C|C|C|C|C|C|C|C|C|C|C|C|C|D|
D|D|D|D|D|D|D|D|D|D|D|D|D|D|D|D|D|D|D|D|D|D|D|D|D|D|D|D|D|D|D|
